0,0,0,0,0,0,0,0,0,0,0,0,0,0,0,0,0,0,0,0,0,0,0,0,0,0,0,0,0,0,0,0,0,0,0,0,0,0,0,0,0,0,0,0,0,0,0,0,0,0,0,0,0,0,0,0,0,0,0,0,0,0,0,0,0,0,0,0,0,0,0,0,0,0,0,0,0,0,0,0,0,0,0,0,0,0,0,0,0,0,0,0,0,0,0,0,0,0,0,0
0,0,0,0,8,8,8,8,8,8,8,8,8,8,8,8,8,8,8,8,8,8,0,0,0,0,0,0,0,0,0,0,0,0,0,8,8,8,8,8,8,8,8,8,8,8,8,8,8,8,8,8,0,0,0,0,0,0,0,0,0,0,0,0,0,0,0,0,0,0,0,0,0,0,0,0,0,0,0,0,0,0,0,0,0,0,0,0,0,0,0,0,0,0,0,0,0,0,0,0
0,0,0,8,7,7,7,7,7,7,7,7,7,7,7,7,7,7,7,7,7,7,8,0,0,0,0,0,0,0,0,0,0,0,8,7,7,7,7,7,7,7,7,7,7,7,7,7,7,7,7,7,8,0,0,0,0,0,0,0,0,0,0,0,0,0,0,0,0,0,0,0,0,0,0,0,0,0,0,0,0,0,0,0,0,0,0,0,0,0,0,0,0,0,0,0,0,0,0,0
0,0,8,7,6,6,6,6,6,6,6,6,6,6,6,6,6,6,6,6,6,6,7,8,0,0,0,0,0,0,0,0,0,8,7,6,6,6,6,6,6,6,6,6,6,6,6,6,6,6,6,6,7,8,0,0,0,0,0,0,0,0,0,0,0,0,0,0,0,0,0,0,0,0,0,0,0,0,0,0,0,0,0,0,0,0,0,0,0,0,0,0,0,0,0,0,0,0,0,0
0,0,8,6,5,5,5,5,5,5,5,5,5,5,5,5,5,5,5,5,5,5,6,7,8,8,8,8,8,8,8,8,8,7,6,5,5,5,5,5,5,5,5,5,5,5,5,5,5,5,5,5,6,7,8,8,8,8,8,8,0,0,0,0,0,0,0,0,0,0,0,0,0,0,0,0,0,0,0,0,0,0,0,0,0,0,0,0,0,0,0,0,0,0,0,0,0,0,0,0
0,0,8,5,2,2,2,2,2,2,2,2,2,2,2,2,2,2,2,2,2,2,5,6,7,7,7,7,7,7,7,7,7,6,5,2,2,2,2,2,2,2,2,2,2,2,2,2,2,2,2,2,5,6,7,7,7,7,7,7,8,0,0,0,0,0,0,0,0,0,0,0,0,0,0,0,0,0,0,8,8,8,8,8,8,8,8,8,8,8,8,8,8,8,8,0,0,0,0,0
0,0,8,2,2,2,2,2,2,2,2,2,2,2,2,2,2,2,2,2,2,2,2,5,6,6,6,6,6,6,6,6,6,5,2,2,2,2,2,2,2,2,2,2,2,2,2,2,2,2,2,2,2,5,6,6,6,6,6,6,7,8,0,0,0,0,0,0,0,0,0,0,0,0,0,0,0,8,8,7,7,7,7,7,7,7,7,7,7,7,7,7,7,7,8,8,8,0,0,0
0,0,8,3,3,3,2,2,3,3,3,2,2,2,3,3,3,2,2,2,3,3,3,2,5,5,5,5,5,5,5,5,5,2,2,2,2,2,2,2,2,2,2,2,2,2,2,2,2,2,2,2,2,2,5,5,5,5,5,5,6,7,8,0,0,0,0,0,0,0,0,0,0,0,0,0,8,8,7,6,6,6,6,6,6,6,6,6,6,6,6,6,6,6,7,7,8,8,0,0
0,0,8,3,4,3,2,2,3,4,3,2,2,2,3,4,3,2,2,2,3,4,3,2,2,2,2,2,2,2,2,2,2,2,2,2,2,2,2,2,2,2,2,2,2,2,2,2,2,2,2,2,2,2,2,2,2,2,2,2,5,6,7,8,0,0,0,0,0,0,0,0,0,0,8,8,7,7,6,5,5,5,5,5,5,5,5,5,5,5,5,5,5,5,6,6,7,8,8,0
0,0,8,3,3,3,2,2,3,3,3,2,2,2,3,3,3,2,2,2,3,3,3,2,2,2,2,2,2,2,2,2,2,2,2,2,2,2,2,2,2,2,2,2,2,2,2,2,2,2,2,2,2,2,2,2,2,2,2,2,2,5,6,8,0,0,0,0,0,0,0,0,0,8,8,7,6,6,5,2,2,2,2,2,2,2,2,2,2,2,2,2,2,2,5,5,6,7,8,0
0,0,8,2,2,2,2,2,2,2,2,2,2,2,2,2,2,2,2,2,2,2,2,2,2,2,2,2,2,2,2,2,2,2,2,2,2,2,2,2,2,2,2,2,2,2,2,2,2,2,2,2,2,2,2,2,2,2,2,2,2,2,5,8,0,0,0,0,0,0,0,0,8,8,7,6,5,5,2,2,2,2,2,2,2,2,2,2,2,2,2,2,2,2,2,2,5,6,8,0
0,0,8,2,2,2,2,2,2,2,2,2,2,2,2,2,2,2,2,2,2,2,2,2,2,2,2,2,2,2,2,2,2,2,2,2,2,2,2,2,2,2,2,2,2,2,2,2,8,8,8,8,2,2,2,2,2,2,2,2,2,2,2,8,0,0,0,0,0,0,0,8,8,7,6,5,2,2,2,2,2,2,2,2,2,2,2,2,2,2,2,2,2,2,2,2,2,5,8,0
0,0,8,2,2,2,2,2,2,2,2,2,2,2,2,2,2,2,2,2,2,2,2,2,2,2,2,2,2,2,2,2,2,2,2,2,2,2,2,2,2,2,2,2,2,2,2,2,8,7,7,8,2,2,2,2,2,2,2,2,2,2,2,8,0,0,0,0,0,8,8,8,7,6,5,2,4,4,4,4,2,2,2,2,2,2,2,2,2,4,4,4,4,2,2,2,2,2,8,0
0,0,8,3,3,3,2,2,3,3,3,2,2,2,3,3,3,2,2,2,3,3,3,2,2,8,8,8,8,8,8,8,2,2,2,2,2,2,2,2,2,2,2,2,2,2,2,2,8,6,6,8,2,2,2,2,2,2,2,2,2,2,2,8,8,8,8,8,8,8,7,7,6,5,2,2,4,4,4,4,4,2,2,2,2,2,2,2,4,4,4,4,4,2,2,2,2,2,8,0
0,0,8,3,4,3,2,2,3,4,3,2,2,2,3,4,3,2,2,2,3,4,3,2,2,8,7,7,7,7,7,8,2,2,2,2,2,2,2,2,2,2,2,2,2,2,2,2,8,5,5,8,2,2,2,2,2,2,2,2,2,2,2,7,7,7,7,7,7,7,6,6,5,2,2,2,4,4,4,4,4,4,4,2,2,2,4,4,4,4,4,4,4,2,2,2,2,2,8,0
0,0,8,3,3,3,2,2,3,3,3,2,2,2,3,3,3,2,2,2,3,3,3,2,2,8,8,8,8,8,8,8,2,2,2,2,2,2,2,2,2,2,2,2,2,2,2,2,8,0,0,8,2,2,2,2,2,2,2,2,2,2,2,6,6,6,6,6,6,6,5,5,2,2,2,2,4,4,3,3,4,4,4,4,4,4,4,4,4,3,3,4,4,2,2,2,2,2,8,0
0,0,8,2,2,2,2,2,2,2,2,2,2,2,2,2,2,2,2,2,2,2,2,2,2,7,7,7,7,7,7,7,2,2,2,2,2,2,2,2,2,2,2,2,2,2,2,2,8,0,0,8,2,2,2,2,2,2,2,2,2,2,2,5,5,5,5,5,5,5,2,2,2,2,2,2,4,4,3,3,3,4,4,4,4,4,4,4,3,3,3,4,4,2,2,2,2,8,8,0
0,0,8,2,2,2,2,2,2,2,2,2,2,2,2,2,2,2,2,2,2,2,2,2,2,6,6,6,6,6,6,6,2,2,2,2,2,2,2,2,2,2,2,2,2,2,2,2,8,0,0,8,2,2,2,2,2,2,2,2,2,2,2,2,2,2,2,2,2,2,2,2,2,2,2,2,4,4,3,3,3,3,3,3,3,3,3,3,3,3,3,4,4,2,2,2,2,8,7,0
0,0,8,2,2,2,2,2,2,2,2,2,2,2,2,2,2,2,2,2,2,2,2,2,2,5,5,5,5,5,5,5,2,2,2,2,2,2,2,2,2,2,2,2,2,2,2,2,8,0,0,8,2,2,2,2,2,2,2,2,2,2,2,2,2,2,2,2,2,2,2,2,2,2,2,2,4,4,3,3,3,3,3,3,3,3,3,3,3,3,3,4,4,2,2,2,2,8,6,0
0,0,8,3,3,3,2,2,3,3,3,2,2,2,3,3,3,2,2,2,3,3,3,2,2,2,2,2,2,2,2,2,2,2,2,2,2,2,2,2,2,2,2,2,2,2,2,2,8,0,0,8,2,2,2,2,2,2,2,2,2,2,2,2,2,2,2,2,2,2,2,2,2,2,2,2,4,4,3,3,3,3,3,3,3,3,3,3,3,3,3,4,4,2,2,2,2,8,5,0
0,0,7,8,4,3,2,2,3,4,3,2,2,2,3,4,3,2,2,2,3,4,3,2,2,2,2,2,2,2,2,2,2,2,2,2,2,2,2,2,2,2,2,2,2,2,2,2,8,0,0,8,2,2,2,2,2,2,2,2,2,2,2,2,2,2,2,2,2,2,2,2,2,2,2,2,4,4,3,3,3,3,3,3,3,3,3,3,3,3,3,4,4,2,2,2,2,8,0,0
0,0,6,7,8,3,2,2,3,3,3,2,2,2,3,3,3,2,2,2,3,3,3,2,2,2,2,2,2,2,2,2,2,2,2,2,2,2,2,2,2,2,2,2,2,2,2,2,8,0,0,8,2,2,2,2,2,2,2,2,2,2,2,2,2,2,2,2,2,2,2,2,2,2,2,2,4,4,3,3,3,3,3,3,3,3,3,3,3,3,3,4,4,2,2,2,2,8,0,0
0,0,5,6,7,8,8,8,8,8,8,2,2,2,2,2,2,2,2,2,2,2,2,2,2,2,2,2,2,2,2,2,2,2,2,2,2,2,2,2,2,2,2,2,2,2,2,2,8,0,0,8,2,2,2,2,2,2,2,2,2,2,2,8,8,8,8,8,8,8,2,2,2,2,2,2,4,4,3,3,3,3,3,3,3,3,3,3,3,3,3,4,4,2,2,2,2,8,0,0
0,0,0,5,6,7,7,7,7,7,8,2,2,2,2,2,2,2,2,2,2,2,2,2,2,8,8,8,8,8,8,8,2,2,2,2,2,2,2,2,2,2,2,2,2,2,2,2,8,0,0,8,2,2,2,2,2,2,2,2,2,2,2,8,7,7,7,7,7,8,8,8,2,2,2,2,4,4,4,3,3,3,3,3,3,3,3,3,3,3,4,4,4,2,2,2,2,8,0,0
0,0,0,0,5,6,6,6,6,6,8,2,2,2,2,2,2,2,2,2,2,2,2,2,2,8,7,7,7,7,7,8,2,2,2,2,2,2,2,2,2,2,2,2,2,2,2,2,8,8,8,8,2,2,2,2,2,2,2,2,2,2,2,8,6,6,6,6,6,7,7,8,8,8,2,2,4,4,4,4,3,3,3,3,3,3,3,3,3,4,4,4,4,2,2,2,8,8,0,0
0,0,0,0,0,5,5,5,5,5,8,2,2,2,3,3,3,2,2,2,3,3,3,2,2,8,8,8,8,8,8,8,2,2,2,2,2,2,2,2,2,2,2,2,2,2,2,2,7,7,7,7,2,2,2,2,2,2,2,2,2,2,2,8,5,5,5,5,5,6,6,7,7,8,2,2,4,4,4,4,4,3,3,3,3,3,3,3,4,4,4,4,4,2,2,2,8,7,0,0
0,0,0,0,0,0,0,0,0,0,8,2,2,2,3,4,3,2,2,2,3,4,3,2,2,7,7,7,7,7,7,7,2,2,2,2,2,2,2,2,2,2,2,2,2,2,2,2,6,6,6,6,2,2,2,2,2,2,2,2,2,2,2,8,0,0,0,0,0,5,5,6,6,8,2,2,4,4,4,4,4,4,4,3,3,3,4,4,4,4,4,4,4,2,2,8,8,6,0,0
0,0,0,0,0,0,0,0,0,0,8,2,2,2,3,3,3,2,2,2,3,3,3,2,2,6,6,6,6,6,6,6,2,2,2,2,2,2,2,2,2,2,2,2,2,2,2,2,5,5,5,5,2,2,2,2,2,2,2,2,2,2,2,8,0,0,0,0,0,0,0,5,5,8,2,2,2,2,2,2,4,4,4,4,4,4,4,4,4,2,2,2,2,2,2,8,7,5,0,0
0,0,0,0,0,8,8,8,8,8,8,2,2,2,2,2,2,2,2,2,2,2,2,2,2,5,5,5,5,5,5,5,2,2,2,2,2,2,2,2,2,2,2,2,2,2,2,2,2,2,2,2,2,2,2,2,2,2,2,2,2,2,2,8,0,0,0,0,0,0,0,0,0,8,2,2,2,2,2,2,2,4,4,4,4,4,4,4,2,2,2,2,2,2,2,8,6,0,0,0
0,0,0,0,0,8,7,7,7,7,7,2,2,2,2,2,2,2,2,2,2,2,2,2,2,2,2,2,2,2,2,2,2,2,2,2,2,2,2,2,2,2,2,2,2,2,2,2,2,2,2,2,2,2,2,2,2,2,2,2,2,2,2,8,0,0,0,0,0,0,0,0,0,8,2,2,2,2,2,2,2,2,2,4,4,4,2,2,2,2,2,2,2,2,2,8,5,0,0,0
0,0,0,0,0,8,6,6,6,6,6,2,2,2,2,2,2,2,2,2,2,2,2,2,2,2,2,2,2,2,2,2,2,2,2,2,2,2,2,2,2,2,2,2,2,2,2,2,8,8,8,8,2,2,2,2,2,2,2,2,2,2,2,8,0,0,0,0,0,0,0,0,0,8,2,2,4,4,4,4,2,2,2,2,2,2,2,2,2,4,4,4,4,2,2,8,0,0,0,0
0,0,0,0,0,8,5,5,5,5,5,2,2,2,3,3,3,2,2,2,3,3,3,2,2,2,2,2,2,2,2,2,2,2,2,2,2,2,2,2,2,2,2,2,2,2,2,2,8,7,7,8,2,2,2,2,2,2,2,2,2,2,2,8,0,0,0,0,0,0,0,8,8,8,2,2,4,4,4,4,4,2,2,2,2,2,2,2,4,4,4,4,4,2,2,8,0,0,0,0
0,0,0,0,0,8,2,2,2,2,2,2,2,2,3,4,3,2,2,2,3,4,3,2,2,2,2,2,2,2,2,2,2,2,2,2,2,2,2,2,2,2,2,2,2,2,2,2,8,6,6,8,2,2,2,2,2,2,2,2,2,2,2,8,0,0,0,0,0,8,8,8,7,7,2,2,4,4,4,4,4,4,4,2,2,2,4,4,4,4,4,4,4,2,2,8,0,0,0,0
0,0,0,0,0,8,2,2,2,2,2,2,2,2,3,3,3,2,2,2,3,3,3,2,2,8,8,8,8,8,8,8,2,2,2,2,2,2,2,2,2,2,2,2,2,2,2,2,8,5,5,8,2,2,2,2,2,2,2,2,2,2,2,8,8,8,8,8,8,8,7,7,6,6,2,2,4,4,3,3,4,4,4,4,4,4,4,4,4,3,3,4,4,2,2,8,0,0,0,0
0,0,0,0,0,8,2,2,2,2,2,2,2,2,2,2,2,2,2,2,2,2,2,2,2,8,7,7,7,7,7,8,2,2,2,2,2,2,2,2,2,2,2,2,2,2,2,2,8,0,0,8,2,2,2,2,2,2,2,2,2,2,2,7,7,7,7,7,7,7,6,6,5,5,2,2,4,4,3,3,3,4,4,4,4,4,4,4,3,3,3,4,4,2,2,8,0,0,0,0
0,0,0,0,0,8,2,2,2,2,2,2,2,2,2,2,2,2,2,2,2,2,2,2,2,8,8,8,8,8,8,8,2,2,2,2,2,2,2,2,2,2,2,2,2,2,2,2,8,0,0,8,2,2,2,2,2,2,2,2,2,2,2,6,6,6,6,6,6,6,5,5,2,2,2,2,4,4,3,3,3,3,3,3,3,3,3,3,3,3,3,4,4,2,2,8,0,0,0,0
0,0,0,0,0,8,2,2,2,2,2,2,2,2,2,2,2,2,2,2,2,2,2,2,2,7,7,7,7,7,7,7,2,2,2,2,2,2,2,2,2,2,2,2,2,2,2,2,8,0,0,8,2,2,2,2,2,2,2,2,2,2,2,5,5,5,5,5,5,5,2,2,2,2,2,2,4,4,3,3,3,3,3,3,3,3,3,3,3,3,3,4,4,2,2,8,0,0,0,0
0,0,0,0,0,8,2,2,3,3,3,2,2,2,3,3,3,2,2,2,3,3,3,2,2,6,6,6,6,6,6,6,2,2,2,2,2,2,2,2,2,2,2,2,2,2,2,2,8,0,0,8,2,2,2,2,2,2,2,2,2,2,2,2,2,2,2,2,2,2,2,2,2,2,2,2,4,4,3,3,3,3,3,3,3,3,3,3,3,3,3,4,4,2,2,8,0,0,0,0
0,0,0,0,0,8,2,2,3,4,3,2,2,2,3,4,3,2,2,2,3,4,3,2,2,5,5,5,5,5,5,5,2,4,4,4,4,2,2,2,2,2,2,2,2,2,4,4,8,0,0,8,2,2,2,2,2,2,2,2,2,2,2,2,2,2,2,2,2,2,2,2,2,2,2,2,4,4,3,3,3,3,3,3,3,3,3,3,3,3,3,4,4,2,2,8,0,0,0,0
0,0,0,0,0,8,2,2,3,3,3,2,2,2,3,3,3,2,2,2,3,3,3,2,2,2,2,2,2,2,2,2,2,4,4,4,4,4,2,2,2,2,2,2,2,4,4,4,8,0,0,8,2,2,2,2,2,2,2,2,2,2,2,2,2,2,2,2,2,2,2,2,2,2,2,2,4,4,3,3,3,3,3,3,3,3,3,3,3,3,3,4,4,2,2,8,0,0,0,0
0,0,0,0,0,8,2,2,2,2,2,2,2,2,2,2,2,2,2,2,2,2,2,2,2,2,2,2,2,2,2,2,2,4,4,4,4,4,4,4,2,2,2,4,4,4,4,4,8,0,0,8,2,2,2,2,2,2,2,2,2,2,2,2,2,2,2,2,2,2,2,2,2,2,2,2,4,4,3,3,3,3,3,3,3,3,3,3,3,3,3,4,4,2,2,8,0,0,0,0
0,0,0,0,0,8,2,2,2,2,2,2,2,2,2,2,2,2,2,2,2,2,2,2,2,2,2,2,2,2,2,2,2,4,4,3,3,4,4,4,4,4,4,4,4,4,3,3,8,0,0,8,2,2,2,2,2,2,2,2,2,2,2,2,2,2,2,2,2,2,2,2,2,2,2,2,4,4,4,3,3,3,3,3,3,3,3,3,3,3,4,4,4,2,2,8,0,0,0,0
0,0,0,0,0,8,2,2,2,2,2,2,2,2,2,2,2,2,2,2,2,2,2,2,2,2,2,2,2,2,2,2,2,4,4,3,3,3,4,4,4,4,4,4,4,3,3,3,8,0,0,8,2,2,2,2,2,2,2,2,2,2,2,2,2,2,2,2,2,2,2,2,2,2,2,2,4,4,4,4,3,3,3,3,3,3,3,3,3,4,4,4,4,2,2,8,0,0,0,0
0,0,0,0,0,8,2,2,3,3,3,2,2,2,3,3,3,2,2,2,3,3,3,2,2,8,8,8,8,8,8,8,2,4,4,3,3,3,3,3,3,3,3,3,3,3,3,3,8,8,8,8,2,2,2,2,2,2,2,2,2,2,2,2,2,2,2,2,2,2,2,2,2,2,2,2,4,4,4,4,4,3,3,3,3,3,3,3,4,4,4,4,4,2,2,8,0,0,0,0
0,0,0,0,0,8,2,2,3,4,3,2,2,2,3,4,3,2,2,2,3,4,3,2,2,8,7,7,7,7,7,8,2,4,4,3,3,3,3,3,3,3,3,3,3,3,3,3,7,7,7,7,2,2,2,2,2,2,2,2,2,2,2,2,2,2,2,2,2,2,2,2,2,2,2,2,4,4,4,4,4,4,4,3,3,3,4,4,4,4,4,4,4,2,2,8,0,0,0,0
0,0,0,0,0,8,2,2,3,3,3,2,2,2,3,3,3,2,2,2,3,3,3,2,2,8,8,8,8,8,8,8,2,4,4,3,3,3,3,3,3,3,3,3,3,3,3,3,6,6,6,6,2,2,2,2,2,2,2,2,2,2,2,2,2,2,2,2,2,2,2,2,2,2,2,2,2,2,2,2,4,4,4,4,4,4,4,4,4,2,2,2,2,2,2,8,0,0,0,0
0,0,0,0,0,8,2,2,2,2,2,2,2,2,2,2,2,2,2,2,2,2,2,2,2,7,7,7,7,7,7,7,2,4,4,3,3,3,3,3,3,3,3,3,3,3,3,3,5,5,5,5,2,2,2,2,2,2,2,2,2,2,2,2,2,2,2,2,2,2,2,2,2,2,2,2,2,2,2,2,2,4,4,4,4,4,4,4,2,2,2,2,2,2,2,8,0,0,0,0
0,0,0,0,0,8,2,2,2,2,2,2,2,2,2,2,2,2,2,2,2,2,2,2,2,6,6,6,6,6,6,6,2,4,4,3,3,3,3,3,3,3,3,3,3,3,3,3,4,4,2,2,2,2,2,2,2,2,2,2,2,2,2,2,2,2,2,2,2,2,2,2,2,2,2,2,2,2,2,2,2,2,2,4,4,4,2,2,2,2,2,2,2,2,2,8,0,0,0,0
0,0,0,0,0,8,2,2,2,2,2,2,2,2,2,2,2,2,2,2,2,2,2,2,2,5,5,5,5,5,5,5,2,4,4,3,3,3,3,3,3,3,3,3,3,3,3,3,4,4,2,2,2,2,2,2,2,2,2,2,2,2,2,2,2,2,2,2,2,2,2,2,2,2,2,2,2,2,2,2,2,2,2,2,2,2,2,2,2,2,2,2,2,2,8,7,0,0,0,0
0,0,0,0,0,8,2,2,3,3,3,2,2,2,3,3,3,2,2,2,3,3,3,2,2,2,2,2,2,2,2,2,2,4,4,4,3,3,3,3,3,3,3,3,3,3,3,4,4,4,2,2,2,2,2,2,2,8,8,8,8,8,2,2,2,2,2,2,2,2,2,2,2,8,8,8,8,8,2,2,2,2,2,2,2,2,2,2,2,2,2,2,2,8,7,6,0,0,0,0
0,0,0,0,0,8,2,2,3,4,3,2,2,2,3,4,3,2,2,2,3,4,3,2,2,2,2,2,2,2,2,2,2,4,4,4,4,3,3,3,3,3,3,3,3,3,4,4,4,4,2,2,2,2,2,2,8,8,7,7,7,8,8,2,2,2,2,2,2,2,2,2,8,8,7,7,7,8,8,2,2,2,2,2,2,2,2,2,2,2,2,2,8,7,6,5,0,0,0,0
0,0,0,0,0,8,8,8,8,3,3,2,2,2,3,3,3,2,2,2,3,3,3,2,2,2,2,2,2,2,2,2,2,4,4,4,4,4,3,3,3,3,3,3,3,4,4,4,4,4,2,2,2,2,2,8,8,7,6,6,6,7,8,8,2,2,2,2,2,2,2,8,8,7,6,6,6,7,8,8,2,2,2,2,2,2,2,2,2,2,2,8,7,6,5,0,0,0,0,0
0,0,0,0,0,7,7,7,8,2,2,2,2,2,2,2,2,2,2,2,2,2,2,2,2,2,2,2,2,2,2,2,2,4,4,4,4,4,4,4,3,3,3,4,4,4,4,4,4,4,2,2,2,2,8,8,7,6,5,5,5,6,7,8,8,2,2,2,2,2,8,8,7,6,5,5,5,6,7,8,8,2,2,2,2,2,2,2,2,2,8,7,6,5,0,0,0,0,0,0
0,0,0,0,0,6,6,6,8,8,8,2,2,2,2,2,2,2,2,2,2,2,2,2,2,2,2,2,2,2,2,2,2,2,2,2,2,4,4,4,4,4,4,4,4,4,2,2,2,2,2,2,2,8,8,7,6,5,0,0,0,5,6,7,8,8,2,2,2,8,8,7,6,5,0,0,0,5,6,7,8,8,2,2,2,2,2,2,2,8,7,6,5,0,0,0,0,0,0,0
0,0,0,0,0,5,5,5,7,7,8,2,2,2,2,2,2,2,2,2,2,2,2,2,2,2,2,2,2,2,2,2,2,2,2,2,2,2,4,4,4,4,4,4,4,2,2,2,2,2,2,2,2,8,7,6,5,0,0,0,0,0,5,7,7,8,8,8,8,8,7,6,5,0,0,0,0,0,5,6,7,8,8,8,8,8,8,8,8,7,6,5,0,0,0,0,0,0,0,0
0,0,0,0,0,0,0,0,6,6,8,8,8,8,8,8,8,8,8,8,8,8,8,8,8,8,8,8,8,8,2,2,2,2,2,2,2,2,2,2,4,4,4,2,2,2,2,2,2,2,2,2,2,8,6,5,0,0,0,0,0,0,0,6,6,7,7,7,7,7,6,5,0,0,0,0,0,0,0,5,6,7,7,7,7,7,7,7,7,6,5,0,0,0,0,0,0,0,0,0
0,0,0,0,0,0,0,0,5,5,7,7,7,7,7,7,7,7,7,7,7,7,7,7,7,7,7,7,7,8,2,2,2,4,4,4,4,2,2,2,2,2,2,2,2,2,4,4,4,4,2,2,2,8,5,0,0,0,0,0,0,0,0,5,5,6,6,6,6,6,5,0,0,0,0,0,0,0,0,0,5,6,6,6,6,6,6,6,6,5,0,0,0,0,0,0,0,0,0,0
0,0,0,0,0,0,0,0,0,0,6,6,6,6,6,6,6,6,6,6,6,6,6,6,6,6,6,6,6,8,2,2,2,4,4,4,4,4,2,2,2,2,2,2,2,4,4,4,4,4,2,2,2,8,0,0,0,0,0,0,0,0,0,0,0,5,5,5,5,5,0,0,0,0,0,0,0,0,0,0,0,5,5,5,5,5,5,5,5,0,0,0,0,0,0,0,0,0,0,0
0,0,0,0,0,0,0,0,0,0,5,5,5,5,5,5,5,5,5,5,5,5,5,5,5,5,5,5,5,8,2,2,2,4,4,4,4,4,4,4,2,2,2,4,4,4,4,4,4,4,2,2,2,8,0,0,0,0,0,0,0,0,0,0,0,0,0,0,0,0,0,0,0,0,0,0,0,0,0,0,0,0,0,0,0,0,0,0,0,0,0,0,0,0,0,0,0,0,0,0
0,0,0,0,0,0,0,0,0,0,0,0,0,0,0,0,0,0,0,0,0,0,0,0,0,0,0,0,0,8,2,2,2,4,4,3,3,4,4,4,4,4,4,4,4,4,3,3,4,4,2,2,2,8,0,0,0,0,0,0,0,0,0,0,0,0,0,0,0,0,0,0,0,0,0,0,0,0,0,0,0,0,0,0,0,0,0,0,0,0,0,0,0,0,0,0,0,0,0,0
0,0,0,0,0,0,0,0,0,0,0,0,0,0,0,0,0,0,0,0,0,0,0,0,0,0,0,0,0,8,2,2,2,4,4,3,3,3,4,4,4,4,4,4,4,3,3,3,4,4,2,2,2,8,0,0,0,0,0,0,0,0,0,0,0,0,0,0,0,0,0,0,0,0,0,0,0,0,0,0,0,0,0,0,0,0,0,0,0,0,0,0,0,0,0,0,0,0,0,0
0,0,0,0,0,0,0,0,0,0,0,0,0,0,0,0,0,0,0,0,0,0,0,0,0,0,0,0,0,8,2,2,2,4,4,3,3,3,3,3,3,3,3,3,3,3,3,3,4,4,2,2,2,8,0,0,0,0,0,0,0,0,0,0,0,0,0,0,0,0,0,0,0,0,0,0,0,0,0,0,0,0,0,0,0,0,0,0,0,0,0,0,0,0,0,0,0,0,0,0
0,0,0,0,0,0,0,0,0,0,0,0,0,0,0,0,0,0,0,0,0,0,0,0,0,0,0,0,0,8,2,2,2,4,4,3,3,3,3,3,3,3,3,3,3,3,3,3,4,4,2,2,2,8,0,0,0,0,0,0,0,0,0,0,0,0,0,0,0,0,0,0,0,0,0,0,0,0,0,0,0,0,0,0,0,0,0,0,0,0,0,0,0,0,0,0,0,0,0,0
0,0,0,0,0,0,0,0,0,0,0,0,0,0,0,0,0,0,0,0,0,0,0,0,0,0,0,0,0,8,2,2,2,4,4,3,3,3,3,3,3,3,3,3,3,3,3,3,4,4,2,2,2,8,0,0,0,0,0,0,0,0,0,0,0,0,0,0,0,0,0,0,0,0,0,0,0,0,0,0,0,0,0,8,8,8,8,8,8,8,8,8,8,8,0,0,0,0,0,0
0,0,0,0,0,0,0,0,0,0,0,0,0,0,0,0,0,0,0,0,0,0,0,0,0,0,0,0,0,8,2,2,2,4,4,3,3,3,3,3,3,3,3,3,3,3,3,3,4,4,2,2,2,8,0,0,0,0,0,0,8,8,8,8,8,8,8,8,8,8,8,8,0,0,0,0,0,0,0,0,0,0,8,8,7,7,7,7,7,7,7,7,7,8,8,0,0,0,0,0
0,0,0,0,0,0,0,0,0,0,0,0,0,0,0,0,0,0,0,0,0,0,0,0,0,0,0,0,0,8,2,2,2,4,4,3,3,3,3,3,3,3,3,3,3,3,3,3,4,4,2,2,2,8,8,8,8,8,8,8,8,7,7,7,7,7,7,7,7,7,7,8,8,8,8,8,8,8,8,8,8,8,8,7,6,6,6,6,6,6,6,6,6,7,8,8,0,0,0,0
0,0,0,0,0,0,0,0,0,0,0,0,0,0,0,0,0,0,0,0,0,0,0,0,0,0,8,8,8,8,2,2,2,4,4,3,3,3,3,3,3,3,3,3,3,3,3,3,4,4,2,2,2,7,7,7,7,7,7,7,7,6,6,6,6,6,6,6,6,6,6,7,7,7,7,7,7,7,7,7,7,7,7,6,5,5,5,5,5,5,5,5,5,6,7,8,8,0,0,0
0,0,0,0,0,0,0,0,0,0,0,0,0,0,0,0,0,0,0,0,0,0,0,0,0,0,8,7,7,7,2,2,2,4,4,4,3,3,3,3,3,3,3,3,3,3,3,4,4,4,2,2,2,6,6,6,6,6,6,6,6,5,5,5,5,5,5,5,5,5,5,6,6,6,6,6,6,6,6,6,6,6,6,5,2,2,2,2,2,2,2,2,2,5,6,7,8,0,0,0
0,0,0,0,0,0,0,0,0,0,0,0,0,0,0,0,0,0,0,0,0,0,0,0,0,0,8,6,6,6,2,2,2,4,4,4,4,3,3,3,3,3,3,3,3,3,4,4,4,4,2,2,2,5,5,5,5,5,5,5,5,2,2,2,2,2,2,2,2,2,2,5,5,5,5,5,5,5,5,5,5,5,5,2,2,2,2,2,2,2,2,2,2,2,5,6,8,0,0,0
0,0,0,0,0,0,0,0,0,0,0,0,0,0,0,0,0,0,0,0,0,0,0,8,8,8,8,5,5,5,2,2,2,4,4,4,4,4,3,3,3,3,3,3,3,4,4,4,4,4,2,2,2,2,2,2,2,2,2,2,2,2,2,2,2,2,2,2,2,2,2,2,2,2,2,2,2,2,2,2,2,2,2,2,2,2,2,2,2,2,2,2,2,2,2,5,8,8,0,0
0,0,0,0,0,0,0,0,0,0,0,0,0,0,0,0,0,0,0,0,0,0,0,8,7,7,7,2,2,2,2,2,2,4,4,4,4,4,4,4,3,3,3,4,4,4,4,4,4,4,2,2,2,2,2,2,2,2,2,2,2,2,2,2,2,2,2,2,2,2,2,2,2,2,2,2,2,2,2,2,2,2,2,2,2,2,2,2,2,2,2,2,2,2,2,2,7,8,0,0
0,0,0,0,0,0,0,0,0,0,0,0,0,0,0,0,0,0,0,0,0,0,0,8,6,6,6,2,2,2,2,2,2,2,2,2,2,4,4,4,4,4,4,4,4,4,2,2,2,2,2,2,2,2,2,2,2,2,2,2,2,2,2,2,2,2,2,2,2,2,2,2,2,2,2,2,2,2,2,2,2,2,2,2,2,2,2,2,2,2,2,2,2,2,2,2,6,8,0,0
0,0,0,0,0,0,0,0,0,0,0,0,0,0,0,0,0,0,0,0,8,8,8,8,5,5,5,2,2,2,2,2,2,2,2,2,2,2,4,4,4,4,4,4,4,2,2,2,2,2,2,2,2,2,2,2,2,2,2,2,2,2,2,2,2,2,2,2,2,2,2,2,2,2,2,2,2,2,2,2,2,2,2,2,2,2,2,2,2,2,2,2,2,2,2,2,5,8,0,0
0,0,0,0,0,0,0,0,0,0,0,0,0,0,0,0,0,0,0,0,8,7,7,7,2,2,2,2,2,2,2,2,2,2,2,2,2,2,2,2,4,4,4,2,2,2,2,2,2,2,2,2,2,2,2,2,2,2,2,2,2,2,2,2,2,2,2,2,2,2,2,2,2,2,2,2,2,2,2,2,2,2,2,2,2,2,2,2,2,2,2,2,2,2,2,2,2,8,0,0
0,0,0,0,0,0,0,0,0,0,0,0,0,0,0,0,0,0,0,0,8,6,6,6,2,2,2,2,2,2,2,2,2,4,4,4,4,2,2,2,2,2,2,2,2,2,4,4,4,4,2,2,2,2,2,4,4,4,4,2,2,2,2,2,2,2,2,2,4,4,4,4,2,2,2,2,2,4,4,4,4,2,2,2,2,2,2,2,2,2,4,4,4,4,2,2,2,8,8,0
0,0,0,0,0,0,0,0,0,0,0,0,0,0,0,0,0,8,8,8,8,5,5,5,2,2,2,2,2,2,2,2,2,4,4,4,4,4,2,2,2,2,2,2,2,4,4,4,4,4,2,2,2,2,2,4,4,4,4,4,2,2,2,2,2,2,2,4,4,4,4,4,2,2,2,2,2,4,4,4,4,4,2,2,2,2,2,2,2,4,4,4,4,4,2,2,2,7,8,0
0,0,0,0,0,0,0,0,0,0,0,0,0,0,0,0,0,8,7,7,7,2,2,2,2,2,2,2,2,2,2,2,2,4,4,4,4,4,4,4,2,2,2,4,4,4,4,4,4,4,2,2,2,2,2,4,4,4,4,4,4,4,2,2,2,4,4,4,4,4,4,4,2,2,2,2,2,4,4,4,4,4,4,4,2,2,2,4,4,4,4,4,4,4,2,2,2,6,8,0
0,0,0,0,0,0,0,0,0,0,0,0,0,0,0,0,0,8,6,6,6,2,2,2,2,2,2,2,2,2,2,2,2,4,4,3,3,4,4,4,4,4,4,4,4,4,3,3,4,4,2,2,2,2,2,4,4,3,3,4,4,4,4,4,4,4,4,4,3,3,4,4,2,2,2,2,2,4,4,3,3,4,4,4,4,4,4,4,4,4,3,3,4,4,2,2,2,5,8,0
0,0,0,0,0,0,0,0,0,0,0,0,0,0,8,8,8,8,5,5,5,2,2,2,2,2,2,2,2,2,2,2,2,4,4,3,3,3,4,4,4,4,4,4,4,3,3,3,4,4,2,2,2,2,2,4,4,3,3,3,4,4,4,4,4,4,4,3,3,3,4,4,2,2,2,2,2,4,4,3,3,3,4,4,4,4,4,4,4,3,3,3,4,4,2,2,2,2,8,0
0,0,0,0,0,0,0,0,0,0,0,0,0,0,8,7,7,7,2,2,2,2,2,2,2,2,2,2,2,2,2,2,2,4,4,3,3,3,3,3,3,3,3,3,3,3,3,3,4,4,2,2,2,2,2,4,4,3,3,3,3,3,3,3,3,3,3,3,3,3,4,4,2,2,2,2,2,4,4,3,3,3,3,3,3,3,3,3,3,3,3,3,4,4,2,2,2,2,8,0
0,0,0,0,0,0,0,0,0,0,0,0,0,0,8,6,6,6,2,2,2,2,2,2,2,2,2,2,2,2,2,2,2,4,4,3,3,3,3,3,3,3,3,3,3,3,3,3,4,4,2,2,2,2,2,4,4,3,3,3,3,3,3,3,3,3,3,3,3,3,4,4,2,2,2,2,2,4,4,3,3,3,3,3,3,3,3,3,3,3,3,3,4,4,2,2,2,2,8,0
0,0,0,0,0,0,0,0,0,0,0,8,8,8,8,5,5,5,2,2,2,2,2,2,2,2,2,2,2,2,2,2,2,4,4,3,3,3,3,3,3,3,3,3,3,3,3,3,4,4,2,2,2,2,2,4,4,3,3,3,3,3,3,3,3,3,3,3,3,3,4,4,2,2,2,2,2,4,4,3,3,3,3,3,3,3,3,3,3,3,3,3,4,4,2,2,2,2,8,0
0,0,0,0,0,0,0,0,0,0,0,8,7,7,7,2,2,2,2,2,2,2,2,2,2,2,2,2,2,2,2,2,2,4,4,3,3,3,3,3,3,3,3,3,3,3,3,3,4,4,2,2,2,2,2,4,4,3,3,3,3,3,3,3,3,3,3,3,3,3,4,4,2,2,2,2,2,4,4,3,3,3,3,3,3,3,3,3,3,3,3,3,4,4,2,2,2,2,8,0
0,0,0,0,0,0,0,0,0,0,0,8,6,6,6,2,2,2,2,2,2,2,2,2,2,2,2,2,2,2,2,2,2,4,4,3,3,3,3,3,3,3,3,3,3,3,3,3,4,4,2,2,2,2,2,4,4,3,3,3,3,3,3,3,3,3,3,3,3,3,4,4,2,2,2,2,2,4,4,3,3,3,3,3,3,3,3,3,3,3,3,3,4,4,2,2,2,2,8,0
0,0,0,0,0,0,0,0,8,8,8,8,5,5,5,2,2,2,2,2,2,2,2,2,2,2,2,2,2,2,2,2,2,4,4,3,3,3,3,3,3,3,3,3,3,3,3,3,4,4,2,2,2,2,2,4,4,3,3,3,3,3,3,3,3,3,3,3,3,3,4,4,2,2,2,2,2,4,4,3,3,3,3,3,3,3,3,3,3,3,3,3,4,4,2,2,2,2,8,0
0,0,0,0,0,0,0,0,8,7,7,7,2,2,2,2,2,2,2,2,2,2,2,2,2,2,2,2,2,2,2,2,2,4,4,4,3,3,3,3,3,3,3,3,3,3,3,4,4,4,2,2,2,2,2,4,4,4,3,3,3,3,3,3,3,3,3,3,3,4,4,4,2,2,2,2,2,4,4,4,3,3,3,3,3,3,3,3,3,3,3,4,4,4,2,2,2,2,8,0
0,0,0,0,0,0,0,0,8,6,6,6,2,2,2,2,2,2,2,2,2,2,2,2,2,2,2,2,2,2,2,2,2,4,4,4,4,3,3,3,3,3,3,3,3,3,4,4,4,4,2,2,2,2,2,4,4,4,4,3,3,3,3,3,3,3,3,3,4,4,4,4,2,2,2,2,2,4,4,4,4,3,3,3,3,3,3,3,3,3,4,4,4,4,2,2,2,2,8,0
0,0,0,0,0,0,0,0,8,5,5,5,2,2,2,2,2,2,2,2,2,2,2,2,2,2,2,2,2,2,2,2,2,4,4,4,4,4,3,3,3,3,3,3,3,4,4,4,4,4,2,2,2,2,2,4,4,4,4,4,3,3,3,3,3,3,3,4,4,4,4,4,2,2,2,2,2,4,4,4,4,4,3,3,3,3,3,3,3,4,4,4,4,4,2,2,2,2,8,0
0,0,0,0,0,0,0,0,8,2,2,2,2,2,2,2,2,2,2,2,2,2,2,2,2,2,2,2,2,2,2,2,2,4,4,4,4,4,4,4,3,3,3,4,4,4,4,4,4,4,2,2,2,2,2,4,4,4,4,4,4,4,3,3,3,4,4,4,4,4,4,4,2,2,2,2,2,4,4,4,4,4,4,4,3,3,3,4,4,4,4,4,4,4,2,2,2,8,8,0
0,0,0,0,0,0,0,0,8,2,2,2,2,2,2,2,2,2,2,2,2,2,2,2,2,2,2,2,2,2,2,2,2,2,2,2,2,4,4,4,4,4,4,4,4,4,2,2,2,2,2,2,2,2,2,2,2,2,2,4,4,4,4,4,4,4,4,4,2,2,2,2,2,2,2,2,2,2,2,2,2,4,4,4,4,4,4,4,4,4,2,2,2,2,2,2,8,8,7,0
0,0,0,0,0,0,0,0,8,2,2,2,2,2,2,2,2,2,2,2,2,2,2,2,2,2,2,2,2,2,2,2,2,2,2,2,2,2,4,4,4,4,4,4,4,2,2,2,2,2,2,2,2,2,2,2,2,2,2,2,4,4,4,4,4,4,4,2,2,2,2,2,2,2,2,2,2,2,2,2,2,2,4,4,4,4,4,4,4,2,2,2,2,2,2,8,8,7,6,0
0,0,0,0,0,0,0,0,8,2,2,2,2,2,2,2,2,2,2,2,2,2,2,2,2,2,2,2,2,2,2,2,2,2,2,2,2,2,2,2,4,4,4,2,2,2,2,2,2,2,2,2,2,2,2,2,2,2,2,2,2,2,4,4,4,2,2,2,2,2,2,2,2,2,2,2,2,2,2,2,2,2,2,2,4,4,4,2,2,2,2,2,2,2,8,8,7,6,5,0
0,0,0,0,0,0,0,0,8,2,2,2,2,2,2,2,2,2,2,2,2,2,2,2,2,2,2,2,2,2,2,2,2,2,2,2,2,2,2,2,2,2,2,2,2,2,2,2,2,2,2,2,2,2,2,2,2,2,2,2,2,2,2,2,2,2,2,2,2,2,2,2,2,2,2,2,2,2,2,2,2,2,2,2,2,2,2,2,2,8,8,8,8,8,8,7,6,5,0,0
0,0,0,0,0,0,0,0,8,8,8,8,8,8,8,8,8,8,8,8,8,8,8,8,8,8,8,8,8,8,8,8,8,8,8,8,8,8,8,8,8,8,8,8,8,8,8,8,8,8,8,8,8,8,8,8,8,8,8,8,8,8,8,8,8,8,8,8,8,8,8,8,8,8,8,8,8,8,8,8,8,8,8,8,8,8,8,8,8,8,7,7,7,7,7,6,5,0,0,0
0,0,0,0,0,0,0,0,7,7,7,7,7,7,7,7,7,7,7,7,7,7,7,7,7,7,7,7,7,7,7,7,7,7,7,7,7,7,7,7,7,7,7,7,7,7,7,7,7,7,7,7,7,7,7,7,7,7,7,7,7,7,7,7,7,7,7,7,7,7,7,7,7,7,7,7,7,7,7,7,7,7,7,7,7,7,7,7,7,7,6,6,6,6,6,5,0,0,0,0
0,0,0,0,0,0,0,0,6,6,6,6,6,6,6,6,6,6,6,6,6,6,6,6,6,6,6,6,6,6,6,6,6,6,6,6,6,6,6,6,6,6,6,6,6,6,6,6,6,6,6,6,6,6,6,6,6,6,6,6,6,6,6,6,6,6,6,6,6,6,6,6,6,6,6,6,6,6,6,6,6,6,6,6,6,6,6,6,6,6,5,5,5,5,5,0,0,0,0,0
0,0,0,0,0,0,0,0,5,5,5,5,5,5,5,5,5,5,5,5,5,5,5,5,5,5,5,5,5,5,5,5,5,5,5,5,5,5,5,5,5,5,5,5,5,5,5,5,5,5,5,5,5,5,5,5,5,5,5,5,5,5,5,5,5,5,5,5,5,5,5,5,5,5,5,5,5,5,5,5,5,5,5,5,5,5,5,5,5,5,0,0,0,0,0,0,0,0,0,0
0,0,0,0,0,0,0,0,0,0,0,0,0,0,0,0,0,0,0,0,0,0,0,0,0,0,0,0,0,0,0,0,0,0,0,0,0,0,0,0,0,0,0,0,0,0,0,0,0,0,0,0,0,0,0,0,0,0,0,0,0,0,0,0,0,0,0,0,0,0,0,0,0,0,0,0,0,0,0,0,0,0,0,0,0,0,0,0,0,0,0,0,0,0,0,0,0,0,0,0
0,0,0,0,0,0,0,0,0,0,0,0,0,0,0,0,0,0,0,0,0,0,0,0,0,0,0,0,0,0,0,0,0,0,0,0,0,0,0,0,0,0,0,0,0,0,0,0,0,0,0,0,0,0,0,0,0,0,0,0,0,0,0,0,0,0,0,0,0,0,0,0,0,0,0,0,0,0,0,0,0,0,0,0,0,0,0,0,0,0,0,0,0,0,0,0,0,0,0,0
0,0,0,0,0,0,0,0,0,0,0,0,0,0,0,0,0,0,0,0,0,0,0,0,0,0,0,0,0,0,0,0,0,0,0,0,0,0,0,0,0,0,0,0,0,0,0,0,0,0,0,0,0,0,0,0,0,0,0,0,0,0,0,0,0,0,0,0,0,0,0,0,0,0,0,0,0,0,0,0,0,0,0,0,0,0,0,0,0,0,0,0,0,0,0,0,0,0,0,0
